9
49
4
1
4
47
100
#################################################
#             ############        ###############
# ######### ############## ###### ###############
# ######### ############## ###### ###############
> ######### ############## ###### ############  >
########### ############## ###### ############  #
########### ############## ###### ############  #
###########                ######               #
#################################################