9
49
4
48
4
0
100
#################################################
#                        #           #          #
#         #              #           ###        #
#         #              #     #       #        #
<=        #                    #       #       <=
#         #                    #                #
#                              #                #
#                              #                #
#################################################