9
49
4
47
4
1
100
6
7
#################################################
#                        #           #          #
#         #              #           ###        #
#         #              2     3       5        #
<         #                    #       6        <
#         1                    4                #
#                              #                #
#                              #                #
#################################################