9
49
4
1
4
47
100
8
7
#################################################
#             ###########4        ###############
# ########1 ############## ##5##6 ###############
# ######### ############## ###### ###############
> ######### #############3 ###### ############  >
########### ############## ###### 7###########  #
########### ####2######### ###### #8##########  #
###########                ######               #
#################################################