9
49
4
47
4
1
100
#################################################
#                        #           #          #
#         #              #           ###        #
#         #              #     #       #        #
<         #                    #       #        <
#         #                    #                #
#                              #                #
#                              #                #
#################################################